%%%%%%%%%%%%%
%           %
% %%%%%%%%P %
% .%        %
%        %%%%
%%%%%%%%%%%%%